16
16
1111111111111111
1111111111111111
1111111111111111
1111111111111111
1111000000001111
1111022222201111
1111020220201111
1111000000001111
1111000000001111
1111000000001111
1111111011111111
1111000000001111
1111111111111111
1111111111111111
1111111111111111
1111111111111111